   EA  ./execution/5.png   

NO ./execution/5.png  

  
SO  ./execution/5.png
WE  ./execution/5.png


F 3,3,3

C 0,0,50



111111111111111111           1111111111111111111111111111   
100001000000000001           10001
100001000000000001           10001
100001000000000001           10001
100011000000000001           10001
1000110000000000011          10001
1000D0000000000001           10001
10001000000000001           10001
100010DD0000000001           10001
100010DD0000000001           10001
1000100000000000011          10001
1000100N00000000001         10001
10001000000000000001       110001
10001111111111111101     1100011
10001            101111 100011
1001  1       11100000010001
101  101    110000000000001
101   1    10000000000000001
101       1000000000000000001
101111111100000000000000000001
100000000000000000010000000001
111111111100000000000000000001
          1000000000000000001
           10000000000000001
            110000000000011
              111000001111
               1111111
