   EA  ./execution/5.png   

NO ./execution/5.png  

  
SO  ./execution/5.png
WE  ./execution/5.png


F 3,3,3

C 0,0,50

111111111111111111           11111111111111111
100W01000000000001           10001
100000000000000101           10001
100001000000000001           10001
100010000001000001           10001
1000110000000000011          10001
1000110000000000001         10001
10001100000000000001       110001
10001111111111111101     1100011
10001            101111 100011
1001  1       11100000010001
101  101    110000000000001
101   1    10000000000000001
101       1000000000000000001
101111111100000000000000000001
 1      1111111111111111111111