EA ./path_to_the_east_texture
NO ./path_to_the_north_texture
SO ./path_to_the_south_texture
WE ./path_to_the_west_texture

F 225,0,0



C 225,30,0

111111111111111111           11111111111111111
100001000000000001           10001            
100000000000000101           10001
100001000000000001           10001
100010000001000001           10001
1000110000000000011          10001
1000110W00000000001         10001
10001100000000000001       110001
10001111111111111101     1100011
10001            101111 100011
1001  1       11100000010001
101  101    110000000000001
101   1    10000000000000001
101       1000000000000000001
101111111100000000000000000001
 1      1111111111111111111111