EA texts/5.png 
NO texts/5.png 
SO  texts/5.png          
WE  texts/5.png 


F 128,128,128




      C     10,20,30 


111111111111111111           1111111111111111111111111111
10S0010000001 111            10001
100001010000010001           10001
10000D010000000001           10001
100011110000000001           10001
100011110100000011           10001
100000000000000001           10101
100010000100000011           10001
1000D0000000000001           10001
1000100001D1000011           10001
1000100000000000011          10001
1000100000000000001         10001
10001000000000000001       110001
10001111111111111101     1100011
10001            101111 100011
1001  1       11100000010001
101  101    110000000000101
101   1    10000000000001001
101       1000000000000010001
101111111100000000000000000001
100000000000000000010000000001
111111111100000000000000000001
          1000000000000000001
           10000000000000001
            110000000000011
              111000000111
               111111101
                      1